| | | | | |
| | |x| | |
| | |-| | |
| |-|-|-| |
| | | | | |


base = 5
mult = 1